2-1:865093400194200638002684009507849362286370005309506070401005086600002093903768214
2-2:591840067046791385738625190804507900600019700179238040010902653060104809905300412
2-3:030506827060723194720190035001830762073460951256917483602304570390671240487000006
2-4:701304069038176425002805070325041980009038002847050036083900014196007253070510698
2-5:400739081708261409090540037210904870974180305580327190340672508657013900800095060
2-6:231089647749032058000714093076358400005926031390047865014805302923070586000260914
2-7:036009040080145000541023908450296317612407890903581264100360700395712406060050123
2-8:501402680604801050982560014060100037128374960750629041307900028800200473045783196
2-9:750960813618037905293015476460079008580046397079058064007693580920580731835000640
2-10:605708001700529640029461537316090052582003014497002380160900000058340079974215000
2-11:256413897070002503308765142000209631060081475130506920040007050017024389600958710
2-12:000389100683125479902674835006708340098412057470563290824956703005847000000230000
2-13:925710083834960057176000024600470005347809216590320740200100070759240001018697502
2-14:704068953630500800020403670063741298000059407490800305906080732002675089170032546
2-15:100007029604293815520010370406720103017305068352108907091030780060001092840002631
2-16:920580430563000708704300512610020054495600287832054169258016970076290841100803605
2-17:003102605500390200020504109130740986064928051890013720006409810487260593019857460
2-18:740068290213590706698001500527019008830057410000083957080170365352846109170905024
2-19:013760948000349100970821563109530026802496050056208039300054697401972080007603010
2-20:006700159527094068031006074100468920095020040204915000019000582758240610360851097
2-21:527140038406320905803050140640205009705916423239874061368790004004502300152403097
2-22:235078169409635287680020040143752690098016004760094315050260870376901050801047006
2-23:234097601009600724657214003760180549400060207390472008128746300040350802573908416
2-24:300605047007984361684173259416352978002810604030007100028006013065008402740291580
2-25:625030047080040005004259836456392178097416052231800090142560709060700521508020463
2-26:003079802290368514684105397302080050019042600508937241870094135905706420000853070
2-27:015739460074106058092548370009207140461050709720910085007091004940372516106405297
2-28:809070120362508097571429836700092050004730001005806300413057208956084713207060509
2-29:136082070204617853087943162965030200040791600300065400018359720750100008623870501
2-30:408061793130478020200005481800502004370640108500083069600304917903100846714896530
2-31:025879010701456289800102004010083075583910026000564030368705092207091348140028067
2-32:904750600305069084627841539851406390069078140073910208130094800740030900592087010
2-33:040701562786425310002360804007213458010890720400076093205140037071032905604957081
2-34:298015340041300000036809120000598673053061204900234518680970051305082769479156832
2-35:260001300784023005931586702152060070847300261396007450503708190410692037079130804
2-36:046203895350904172097518060763102000400790238820435716600000001982000007500609483
2-37:340520100107060042269014357001378469476150200803602015634780920710096503905231000
2-38:100096400497028605000041298040835720370409586859260130705083942280974300030000067
2-39:170645280000230047234879006025408360940753820813906075057382194092104758480500600
2-40:090023046608419537734000219085964001967132480003875002312607958006000700479208003
2-41:007100986693804517018679243000341000000902178009006432705493861406010395930500724
2-42:704350812098270540150846079400920060603710954007060200840037625230580107501602483
2-43:279856400005009628486213579892307156104000037703060840007128090900005784500794201
2-44:340960105609070843050483092480625930130000060960318720590106200210097406876054010
2-45:750600980186279354902504160543890721608032000019740836400307698360028415090000203
2-46:037649005006802391009531007003168504640307080780054639364725018912480703078000246
2-47:724013608306750000001804230865107094173498520942635781210386900409001800658200173
2-48:014768950850009704079015680003841029098052406042076108605004097487093260921680040
2-49:041590000635208947289406315596132700018967503307004196962300801050789630870001409
2-50:038009150506142387471000029354018906827006531169375840080004713000020065040031208
2-51:217630050300421607460805103573040061921007380600213570796350810154782936802100040
2-52:608209051390000040012746903475392816006501039139064027850907004024650098063018270
2-53:520000800006050294903802065010209640468315070000467581341628750697031400052974316
2-54:100080753306791048280003901800060530970050684064938102031605097705810326628379415
2-55:420900317073240906690037045109408623800312594000695070204080769936720058785009032
2-56:041075369763009058295308140439650870026830400578024013910043786084702501050086020
2-57:009307214064105800301208950740801629002504183100629040027010098416980572908052060
2-58:420560739006720850500403162963014000200397016041050903007236040004975620652148097
2-59:209386170050700039173925468460873950030240600782650000520190840304568720007432006
2-60:310807956450106802080023017930750084700934561145600000090368075001479328003215649
2-61:809042076100096850007008900910650402006081395084923607600139748798060030430875009
2-62:759006001830195406460708920386572140097010003145360200623980050970250618010647090
2-63:374859602062431059010726008090643820423000167608010093049178236280004070107560084
2-64:856340029309002580072589030000008392000217645265090800704030251023074908081905073
2-65:042050010060014327010020408921460780675902043384570690497005861230040570106098234
2-66:007500260910720504500489173896300715740050002320971846254860031079030608638190027
2-67:265718304879045162100690850410839025650004070930500400090086501306001709001973240
2-68:179250400260800350500640712647021893012936540053780020325098176091305280486170905
2-69:043062570270401600816057342008340005431508007592716834124080709359074006087005403
2-70:263904580040080903987005610870109430050376108019428756095842301120063800630791245
2-71:030407518507810342418050609060700200874905163009001784100340900740509821905078406
2-72:057300984430901627692407030700514008819200500240600010504139802300065479986742351
2-73:094317865380050704657890200149583007036172940000640013860031009905428300073065102
2-74:384721090106539802092860701608013279749052003200970405820390614430086920001247308
2-75:096308521500209000200705039027051008063972400159834762071590284900423176600187053
2-76:726314850900000430345690271104730920090000367637209500470100683260843795000967042
2-77:600739018310080796798100432921043607003000050500071003800216374237004961164097825
2-78:001760832000408000600513400020307190968152047103090285297831654340076000816905023
2-79:720350419803901725591270863970040306235600900004530087087010590012890070450720038
2-80:524001869030546127001289040012907056705120398309058070490815732287463010050790084
2-81:819462057670318409304059108190004005057083604006205710738926001060047830542830076
